SPEY: MTOB
SLDE: SLD
ALNG: LNG
BSPP: B5GA
SIPA: SIP
SLPA: SLP
SLPE: SLR
TTR:  TMD
STMA: STMN, STME, SMLV, SMLN, SMLE
STAT: STAN, STAE
SABT: SABN, SABE
SKI: SKIV, SKIN, SKIE, SKLV, SKLN, SKLE
BPA: BPAV, BPAN, BPAE, BPLV, BPLN, BPLE
MDN: MDNV, MDNN, MDNE, MDLV, MDLN, MDLE
DWS: DWSV, DWSL, DWST, DWLV, DWLL, DWLT
MCLT: MCHN, MCHE, MCLV, MCLN, MCLE
SVB: SVBV, SVBN, SVBE
BBSP: BBSN, BBSE, BBLV, BBLN, BBLE
GRHS: GRHN, GRHE, GRLV, GRLN, GRLE
ALNG: ALNN, ALNE, LNLV, LNLN, LNLE
TRN: GTV, GTN, GTE, GLV, GLN, GLE
DLPL: DTRR
TOSP: SPEY, TOBB
MBWW: MBW2
MCPT: MCPZ
MVO: MVOV
MBGA: MGAT
MBLG: MLGT
ATG: MSG
MML: MMLL
ATG: ATGZ
BBL: BBLZ
MGG: MGGZ
TBG: TBGZ
DEG: DEGZ
MROD: R31B9